
# this is a comment
# this is a temporary file
# - aaron

10 10
DDGGBGGGGG
GGGDDGTGTG
GGGGGDDGGG
GGGGGDGGBG
GBGGGDGGGG
GBGGGDGGGG
GGGGDDDDGG
GGGGGDGGGG
GTGGGGBGGG
GGGGGGGBDD