
# this is a comment
# this is a temporary file
# - aaron

10 10
DDGGGGGGGG
GGGDDGGGGG
GGGGGDDGGG
GGGGGDGGGG
GGGGGDGGGG
GGGGGDGGGG
GGGGDDDDGG
GGGGGDGGGG
GGGGGGGGGG
GGGGGGGDDD