
# this is a comment
# this is a temporary file
# - aaron

10 10
DDGGGGGGGG
GGGDDGTGTG
GGGGGDDGGG
GGGGGDGGGG
GGGGGDGGGG
GGGGGDGGGG
GGGGDDDDGG
GGGGGDGGGG
GTGGGGGGGG
GGGGGGGDDD