
# this is a comment
# this is a temporary file
# - aaron

10 10
DDGGBGGGRG
GGGDDGTGTG
GGGGGDDGGG
GGGGGDGGBG
GBRGGDGGGG
GBGGGDGGGG
GGGGDDDDGG
GGGGGDGGGG
GTGGGGBGGG
GGRGGRGBDD